99999999999999999999999999999999999999999999999999999999999999
92111111111111111111111111111111111111111111111111111111111129
91000000000000000000000000000000000000000000000000000000000019
91000000000000000000000000000000000000000000000000000000000019
91000000000000000000000000000000000000000000000000000000000019
91000000000000000000000000000000000000000000000000000000000019
91000000000000000000000000000000000000000000000000000000000019
91000000000000000000000000000000000000000000000000000000000019
91000000000000000000000000000000000000000000000000000000000019
91000000000000000000000000000000000000000000000000000000000019
91000000000000000000000000000000000000000000000000000000000019
91000000000000000000000000000000000000000000000000000000000019
91000000000000000000000000000000000000000000000000000000000019
91000000000000000000000000000000000000000000000000000000000019
91000000000000000000000000000000000000000000000000000000000019
91000111111111111111111111111111111111111111111111111111100019
91000000000000000000000000000000000000000000000000000000000019
91000000000000000000000000000000000000000000000000000000000019
91000000000000000000000000000000000000000000000000000000000019
91000000000000000000000000000000000000000000000000000000000019
91000000000000000000000000000000000000000000000000000000000019
91000000000000000000000000000000000000000000000000000000000019
91000000000000000000000000000000000000000000000000000000000019
91000000000000000000000000000000000000000000000000000000000019
91000000000000000000000000000000000000000000000000000000000019
91000000000000000000000000000000000000000000000000000000000019
91000000000000000000000000000000000000000000000000000000000019
91000000000000000000000000000000000000000000000000000000000019
91000000000000000000000000000000000000000000000000000000000019
91000000000000000000000000000000000000000000000000000000000019
92111111111111111111111111111111111111111111111111111111111129
99999999999999999999999999999999999999999999999999999999999999